11111111111111111111
10001100000000011011
10001110000000001101
10000010000000000111
10000011000100001111
10000001000100001111
10000001000100011111
11000000000100010011
11000000000100011111
11100000001100010101
10110000011000010111
10011100010000010001
10000111100000110001
10000011000000100111
10000000000001100101
10000000011111001101
10000001110000001001
10000011000111100001
10011110010010000001
11111111111111111111
