22222222222222222222
21112211111111122122
21112221111111112212
21111121111111111222
21111122111211112222
21111112111211112222
21111112111211122222
22111111111211121122
22111111111211122222
22211111112211121212
21221111122111121222
21122211121111121112
21111222211111221112
21111122111111211222
21111111111112211212
21111111122222112212
21111112221111112112
21111122111222211112
21122221121121111112
22222222222222222222
