111111111111111111111111111111
100000000000000000001100000001
100000000000000000111000000001
111111000000000001101000000001
100001111111100111001111110001
100000000000000110000000000001
110000000000001100000000000001
111001000000011000000000000001
100000000100011000000000000001
100000000000010000000000000001
100000000000110000000000000001
110000000011100000000000000001
111000111100100000000000000001
110000100000100000000000000001
100000000000100000000000000001
100000000001100000000000000001
111000011110000000000000000001
101111110000000000000000000001
100000000000000000000000000001
100000000000000000000000000001
100000000000000000000000000001
100000000000000000000000000001
100000000000000000000000000001
100000000000000000000000000001
100000000000000000000000000001
100000000000000000000000000001
100000000000000000000000000001
100000000000000000000000000001
101111100111111000000000000001
111111111111111111111111111111
