111111111111111111111111111111
100000001100000000000000000001
100000000100000011100000000001
100000000010001110110000000001
100000100010001000010000000001
111111100010000000010000110001
100000000100000000000000010001
100000001000000010000000010001
100000110000010011000000010001
100000000010100001100100010001
100001100011100000111100000001
101110000001000000000000100001
101000000001000000000001100001
100000000000000100000001000001
100000001000000000000011000001
100000001000001000011100000001
101101111100010001100000000001
100000000000101001000000100001
100000000000011000001011100001
101010011100010000110000010001
100011111010010000000010000001
100001101010001100000111001001
100001011110000110000101001101
100010000010000001111001000101
110110000001111100000001000101
100011100001000010000000000101
100000110010000000100000000001
100000000110000000011000000001
100000000000000000000000000001
111111111111111111111111111111
