222222222222222222222222222222
211111112211111111111111111112
211111111211111122211111111112
211111111121112221221111111112
211111211121112111121111111112
222222211121111111121111221112
211111111211111111111111121112
211111112111111121111111121112
211111221111121122111111121112
211111111121211112211211121112
211112211122211111222211111112
212221111112111111111111211112
212111111112111111111112211112
211111111111111211111112111112
211111112111111111111122111112
211111112111112111122211111112
212212222211121112211111111112
211111111111212112111111211112
211111111111122111112122211112
212121122211121111221111121112
211122222121121111111121111112
211112212121112211111222112112
211112122221111221111212112212
211121111121111112222112111212
221221111112222211111112111212
211122211112111121111111111212
211111221121111111211111111112
211111111221111111122111111112
211111111111111111111111111112
222222222222222222222222222222
