11111111111111111
10011101001111111
10011111001110111
10001010000110011
10000000110100001
10000000010100001
11100000000100001
10111111001100011
10000000000001111
10000000000001011
11001111111000111
11100000101100001
11110000000100001
11111000000000001
10111000100000001
11110011111100001
11111111111111111
