22222222222222222
21122212112222222
21122222112221222
21112121111221122
21111111221211112
21111111121211112
22211111111211112
21222222112211122
21111111111112222
21111111111112122
22112222222111222
22211111212211112
22221111111211112
22222111111111112
21222111211111112
22221122222211112
22222222222222222
